N
16
G
16
X
16
D
32,32
C
10
S
15,8
26,32
3,26
32,3
31,1
22,26
18,29
29,21
5,7
6,2
4,20
31,12
14,32
31,22
32,25
11,22
P
8,10
25,19
18,19
17,3
12,32
12,29
15,14
7,5
10,24
26,23
1,27
30,25
2,13
8,9
22,16
20,8
F
6,27
25,30
4,6
4,16
7,29
4,2
18,25
10,6
17,30
21,4
17,14
32,26
16,29
5,13
30,30
23,20
M
1,1,1,1,1,50,1,1,1,1,1,1,1,1,1,50,1,50,50,1,1,1,1,50,1,1,1,1,1,1,1,1
1,1,1,1,1,1,1,1,1,1,1,1,1,1,1,1,1,1,1,1,1,1,1,1,1,1,1,1,1,1,1,1
1,1,1,1,1,1,1,1,1,1,50,50,1,1,1,1,1,1,50,1,1,1,1,1,1,1,1,1,1,1,1,50
1,1,1,1,1,1,50,1,1,1,50,1,1,1,50,1,1,1,1,1,1,1,1,1,1,1,1,1,1,1,1,1
1,50,1,1,1,1,1,50,1,1,1,1,1,1,1,1,1,1,1,1,50,1,1,1,1,50,1,1,1,50,50,1
1,1,1,1,1,1,1,1,1,1,1,1,1,50,1,1,1,1,1,1,1,1,1,1,1,1,1,1,1,1,1,1
1,1,1,1,1,1,1,1,1,1,1,1,1,1,1,1,1,1,1,1,1,1,1,1,1,1,1,1,1,1,1,1
50,1,1,50,1,1,1,1,1,1,1,1,1,1,1,1,1,1,1,1,50,1,1,1,50,1,1,1,1,1,1,1
1,1,1,1,1,1,1,1,50,1,1,1,1,1,1,1,1,1,1,1,1,50,1,1,1,1,1,1,50,1,50,50
1,50,1,1,1,1,1,1,1,1,1,1,1,1,50,1,1,1,1,1,50,1,1,1,1,1,1,1,50,1,1,1
1,1,1,1,1,1,50,1,1,1,1,1,1,1,1,1,1,1,1,1,1,1,1,1,50,1,1,1,1,1,1,1
1,1,1,1,1,1,1,1,1,1,1,1,1,1,1,1,1,1,1,1,1,1,1,1,1,1,1,50,1,1,1,1
1,50,1,1,1,1,1,50,50,1,1,1,1,1,1,1,1,1,1,1,1,1,50,1,1,1,1,1,1,1,1,1
1,1,1,1,1,1,1,50,1,1,1,1,1,1,1,50,1,1,1,50,1,1,1,1,1,1,1,50,1,1,1,1
1,1,1,1,1,1,1,1,1,1,50,1,1,1,1,1,1,1,1,1,1,1,1,1,1,1,1,1,1,1,1,1
1,1,1,1,1,1,1,1,1,1,1,1,1,1,1,1,1,1,1,1,1,1,1,50,1,1,1,1,1,1,1,1
1,1,1,50,1,1,1,1,1,1,1,1,1,1,1,1,50,1,1,1,1,1,1,1,1,1,1,50,1,1,1,1
1,1,1,1,1,1,1,1,1,1,1,1,1,1,1,1,1,1,1,1,1,1,1,1,1,1,1,1,1,1,1,50
1,1,1,1,1,1,1,50,1,1,1,1,1,1,1,1,50,1,1,1,1,1,1,1,1,1,1,1,1,1,1,1
50,1,1,1,1,1,1,1,1,1,50,1,1,1,1,1,1,1,50,1,1,50,1,1,1,1,1,1,50,1,1,1
1,1,1,1,1,1,1,1,1,1,1,1,1,1,1,50,1,1,1,1,1,50,1,1,1,50,1,1,1,1,1,1
1,1,1,50,1,1,1,1,1,1,50,1,1,1,1,1,50,1,1,1,1,1,1,1,1,1,1,1,1,1,1,1
1,1,50,1,1,1,1,1,1,1,1,1,1,1,1,1,1,1,1,1,1,50,1,50,1,50,1,1,50,1,1,1
1,1,1,50,1,50,1,1,1,50,50,1,1,1,1,1,1,1,1,50,50,1,1,1,1,1,1,1,1,1,1,50
1,1,1,1,1,1,1,1,1,1,1,50,50,50,1,1,1,1,1,1,1,1,1,1,1,1,1,1,1,1,1,50
1,1,1,1,1,1,1,50,1,1,1,1,1,1,1,1,1,1,1,1,1,50,1,1,1,1,1,1,1,1,1,1
1,1,1,1,1,1,1,1,1,1,1,50,1,1,1,1,50,1,1,1,1,1,50,50,1,1,1,1,1,1,1,1
50,1,1,1,1,1,1,1,1,1,1,1,1,50,1,1,1,1,1,1,1,1,1,1,50,1,1,1,1,1,1,1
1,1,1,1,1,1,1,1,1,1,1,1,1,1,1,1,1,1,1,50,1,1,1,1,1,1,1,1,1,1,1,1
1,1,1,50,1,1,1,1,1,1,1,1,1,1,1,50,1,1,1,1,1,1,1,1,1,1,50,1,1,1,1,1
1,1,1,1,1,1,50,1,1,1,1,1,1,1,1,1,1,1,1,1,1,1,50,1,1,1,1,1,1,1,1,1
50,1,1,1,1,1,1,1,1,1,1,1,1,1,50,1,1,50,1,1,1,1,1,50,1,1,1,1,1,1,1,1
