N
8
G
8
D
8,8
C
10
S
1,6
4,7
6,8
6,2
5,4
8,5
5,7
7,5
P
2,2
8,1
4,2
8,6
1,1
5,1
6,5
7,4
F
1,2
2,4
1,4
6,6
3,4
1,8
2,1
3,2
M
1,1,1,1,1,1,1,1
1,1,1,1,1,1,1,1
1,1,1,1,1,1,1,1
1,1,1,1,1,1,1,1
1,1,50,1,1,50,1,1
1,1,1,1,1,1,1,1
1,1,1,1,1,1,50,1
1,1,50,1,1,1,1,1
