N
10
G
10
D
20,20
C
10
S
3,9
6,15
6,18
17,8
10,14
17,13
12,7
18,15
1,14
9,9
P
3,17
7,5
7,8
8,8
11,14
20,15
9,17
3,2
2,4
7,7
F
1,11
2,3
13,18
20,12
11,7
9,10
2,18
2,9
13,17
18,19
M
1,1,1,50,1,1,1,1,1,1,1,1,1,1,1,1,1,1,1,50
1,1,1,1,1,1,1,1,1,1,1,50,1,1,1,1,1,1,1,1
1,1,50,1,1,1,1,1,1,1,1,1,1,1,50,1,1,1,1,1
1,1,1,1,1,1,1,1,1,1,50,1,1,1,1,1,1,1,1,1
50,1,1,1,1,1,1,1,1,1,1,1,1,1,50,1,1,50,1,1
1,1,1,50,1,1,1,1,1,1,1,1,1,1,1,1,1,1,50,1
50,1,1,50,1,50,1,1,1,1,1,1,1,1,1,50,1,1,1,1
1,1,1,1,1,1,1,1,1,1,1,1,1,1,1,1,1,1,1,50
1,1,1,1,1,1,1,1,1,1,1,1,1,1,50,1,1,1,50,1
1,1,1,1,1,1,1,1,1,1,1,1,1,1,50,1,1,1,50,50
1,1,1,1,1,1,1,1,1,1,1,50,1,1,1,1,1,1,1,1
1,1,1,1,1,1,1,1,1,1,1,1,1,1,1,1,1,1,1,1
1,1,1,1,1,1,1,1,1,50,1,1,1,1,1,1,1,1,50,1
1,1,1,1,1,1,1,1,1,1,1,1,1,1,1,1,1,1,50,1
1,1,1,1,1,1,1,50,50,1,1,1,1,1,1,1,1,1,1,1
1,50,1,1,50,1,1,1,1,1,1,50,1,50,1,1,1,1,1,50
1,1,1,1,1,1,1,1,1,1,1,1,1,1,1,1,1,1,1,1
1,1,50,1,1,1,1,1,1,1,1,1,1,1,1,1,50,1,1,1
1,1,1,1,1,1,1,1,1,1,1,50,1,1,1,1,1,1,1,1
1,1,1,1,1,1,1,1,1,1,1,1,1,1,1,1,1,1,1,1
